R 500 500
NO textures/babyy.xpm
SO         textures/redbrick.xpm
EA    textures/purplestone.xpm
WE 	textures/mossy.xpm
F 100,100,100
C 200,200,200
S textures/pillar.xpm
11111111
10W00201
1000001
1002000111111
11111100000001
11111110000001
10000000000001
103300000000001
11111111111111
