NO 		textures/tx1.xpm
EA      textures/tx2.xpm
S 		textures/pillar.xpm
F 	255	,	 	255,		3
R  800             800
WE		textures/tx3.xpm

SO      textures/tx4.xpm

C  		4,			255		,		255




11111111111111111111111
10003000000000000000001
10000120000111110111101
10020000200000000000001
10200200200010002120001
10000000022000001110001
10110002001100002120001
10100002000000200000001
10010100002200000000001
10100100010010111110001
102N0100000000000000001
11111111111111111111111