R 1000 1000
WE		textures/tx3.xpm
EA      textures/tx4.xpm
NO 		textures/tx1.xpm
SO      textures/tx2.xpm
S 					textures/pillar.xpm
F 176,196,222
C 30,144,255
11111111111111111111111111111
10000000000000000000000000001
10000001000000000000000000001
10000000000000000000000000001
10200000000000000100000000001
10200000000000000100000000001
1000000W000000000100000000001
10000000000000000000000000001
10000000000000000000000000001
10000000000000000000000000001
10000000000000000000000000001
10000001100000000000000000001
10000000000000000000000000001
10000000000000000000000000001
10000000000000000000000000001
10000000000000000000000000001
10000000000000000000000000001
10000000000000000000000000001
10000000000000000000000000001
10000000000000000000000000001
10000000000000000000000000001
10000000000000000000000000011
11111111111111111111111111111