R 1000 1000
WE		textures/tx3.xpm
EA      textures/tx4.xpm
NO 		textures/tx1.xpm
SO      textures/tx2.xpm
S 					textures/pillar.xpm
F 176,196,222
C 30,144,255
11111111111111111111111111111
10000202002000000000000000001
10000222000000000000000000001
10010000000000010000000000001
10000002000000010000000000001
10000000000000010000000000001
1001000N000000010000000000001
10000000000000010000000000001
10000000000000000000000000001
10010000000000000000000000001
10000000000000000000000000001
10000000000000000000000010001
10010000000000000000000010001
10110000011100000000000010001
10000000001100000111011110001
11110111111111011100000010001
11110111111111011101010010001
11000000110101011100000010001
10000000000000001100000010001
10000000000000001101010010001
11100000110101011111011000001
11110111111101011111011110001
11111111111111111111111111111