EA      textures/tx2.xpm
S 		textures/pillar.xpm

NO 		textures/tx1.xpm



F 	255	,	 	0,		21




R 	880            800





WE		textures/tx3.xpm



SO      textures/tx4.xpm



C  		4,			255		,152





 	
     1111111111111111111111111111
     1000000000000000000000000001
     10000000000	00000000020000001
     10000000000000N0000000100001
     10000   00000000  00000000 1 
     1111111111110111111111111111
0000000000000000101000000000
1111111111111111101111111111
100000000000000000000000000011111111			
100000000000000000000000000000000001		
100000000000000000000000000011111111			
1000000000000000000000000001
1000000000000000011111111111	
1000000000000000010000000001
1111111111111011110111111111
1111111111111011111111111111
1000000000000000011111111111
1000000000000000010000000001
1111111111111011010111111111
1111111111111011111111111111
1000000000000000011111111111
1000000000000000010000000001
1111111111111011010111111111
1111111111111011111111111111
1000000000000000011111111111
1000000000000000010000000001
1111111111111011010111111111
1111111111111011111111111111
1111111111111111111111111111
1111111111111111111111111111
1111111111111111111111111111
1111111111111111111111111111
1111111111111111111111111111
1111111111111111111111111111
1111111111111111111111111111
1111111111111111111111111111
1111111111111111111111111111
1111111111111111111111111111
1111111111111111111111111111
1111111111111111111111111111
1111111111111111111111111111
1111111111111111111111111111
1111111111111111111111111111
1111111111111111111111111111
1111111111111111111111111111
1111111111111111111111111111
111111111111111111111111111111111111111111111111111111111111111111111111111111111111
11111111111111111111111111111111111111111111111111111111
1111111111111111111111111111
1111111111111111111111111111
1111111111111111111111111111
1111111111111111111111111111
1111111111111111111111111111
1111111111111111111111111111
1111111111111111111111111111
1111111111111111111111111111
1111111111111111111111111111
1111111111111111111111111111
1111111111111111111111111111
1111111111111111111111111111
1111111111111111111111111111
1111111111111111111111111111
1111111111111111111111111111
1111111111111111111111111111
1111111111111111111111111111
1111111111111111111111111111
1111111111111111111111111111
1111111111111111111111111111
1111111111111111111111111111
1111111111111111111111111111
1111111111111111111111111111
1111111111111111111111111111
1111111111111111111111111111
1111111111111111111111111111
1111111111111111111111111111
1111111111111111111111111111
1111111111111111111111111111
1111111111111111111111111111
1111111111111111111111111111
1111111111111111111111111111
1111111111111111111111111111
1111111111111111111111111111
1111111111111111111111111111
1111111111111111111111111111
1111111111111111111111111111
1111111111111111111111111111
1111111111111111111111111111
1111111111111111111111111111
1111111111111111111111111111
1111111111111111111111111111
1111111111111111111111111111
1111111111111111111111111111
1111111111111111111111111111
1111111111111111111111111111
1111111111111111111111111111
1111111111111111111111111111
