R 1000 1000
NO textures/redbrick.xpm
SO textures/eagle.xpm
WE textures/greystone.xpm
EA textures/colorstone.xpm
S textures/barrel.xpm
F 176,196,222
C 30,144,255
11111111111111111111111111111
10000200000000000000200000001
10000000000200022000020000001
10010000000000010000000000001
10000N00020000010002000000001
10000000000000010000020000001
10010020002000010000000000001
10000000000000010000000000001
10000000000000000000000000001
10010000000000000000000000001
10000000000000000000000000001
10000000000000000000000010001
10010000000000000000000010001
10110000011100000000000010001
10000000001100000111011110001
11110111111111011100000010001
11110111111111011101010010001
11000000110101011100000010001
10000000000000001100000010001
10000000000000001101010010001
11100000110101011111011000001
11110111111101011111011110001
11111111111111111111111111111