R       720 1280 


WE		textures/tx3.xpm
EA      textures/tx4.xpm
NO 		textures/tx1.xpm
SO      textures/tx2.xpm
S 		textures/pillar.xpm

F 176,196,222
C 30,144,255


11111111111111111111111
11000000000000000000211
10011120000000000000001
10000000000000000020001
10001111200000000000001
10200100000000000000001
10N00100200000000000001
10000000000000000000001
10110000000000000000001
10000000000000000300001
10000000000000000000001
11111111111111111111111
