EA      textures/tx2.xpm
S 		textures/pillar.xpm
NO 		textures/tx1.xpm
F 	255	,	 	255,		3
R  720             255555
WE		textures/tx3.xpm

SO      textures/tx4.xpm

C  		4,			255		,		255




11111111111111111111111
11N00000000000000000211
10011120000000000000001
10000000000000000020001
10001111200000000000001
10200100000000000000001
10000100200030000000001
10000000000000000000001
10110000000000000000001
10000000000000000000001
10000000000000000000001
11111111111111111111111

