R 1000 1000
WE		textures/tx3.xpm
EA      textures/tx4.xpm
NO 		textures/tx1.xpm
SO      textures/tx2.xpm
S 					textures/pillar.xpm
F 176,196,222
C 30,144,255
1111111111
1100000211
1000000001
1000000001
1000000001
1000000001
1000000001
1000000001
1000000001
1000000001
10000W0001
1111111111