EA      textures/tx2.xpm
S 		textures/pillar.xpm
NO 		textures/tx1.xpm
F 	255	,	 	255,		3
R  500             800
WE		textures/tx3.xpm

SO      textures/tx4.xpm

C  		4,			255		,		255




11111111111111111111111
11000000000000000000011
10011100000000000000001
10000000000000000020001
10001111000000000000001
10000100000000000N00001
10000100000000000000001
10000000000000000000001
10110000000000000000001
10000000000000000000001
10000000000000000000001
11111111111111111111111

