EA      textures/tx2.xpm
S 		textures/pillar.xpm

NO 		textures/mossy.xpm



F 	100	,	 	0,		210




R 	1000            1000





WE		textures/tx3.xpm



SO      textures/redbrick.xpm



C  		4,			30		,152





 	
     1111111111111111111111111111
     10000000000020000000000000001
     1000000000	000000000200000001
     10000000020000000000000100001
     10000   00000000  200000000 1 
     1111111111110111111111111111
0000000000000000101000000000
1111111111111111101111111111
100000000000000000000000000011111111			
10000000000000000000000000000000001		
100000000000000000000000000011111111			
100000000000N000000000000001
1000000000000000011111111111	
1000000000000000010000000001
1111111111111011110111111111
1111111111111111111111111111
1000000000000000011111111111
1000000000000000010000000001
1111111111111011010111111111
1111111111111011111111111111
1000000000000000011111111111
1000000000000000010000000001
1111111111111011010111111111
1111111111111011111111111111
1000000000000000011111111111
1000000000000000010000000001
1111111111111011010111111111
