R 1200 500
WE		textures/tx3.xpm
EA      textures/tx4.xpm
NO 		textures/tx1.xpm
SO      textures/tx2.xpm
S 					textures/pillar.xpm
F 176,196,222
C 30,144,255
1111111111
1100000211
1001112001
1000000001
1000111121
1020010001
10E0010021
1000000001
1011000001
1000000001
1000000001
1111111111