R 1920 1080
NO textures/tx1.xpm
SO textures/tx4.xpm
WE textures/tx2.xpm
EA textures/tx3.xpm
S textures/barrel.xpm
F 220,100,0
C 225,30,0

1111
1 0
1 N1
1111
